10
10
0 0 0 0 1 6 0 0 0 0 
0 0 0 1 1 1 1 0 0 0 
0 0 1 1 7 1 7 1 0 0
0 1 1 1 1 1 1 1 1 0
1 1 8 1 1 1 1 9 1 1 
1 1 1 1 1 1 1 1 1 1 
0 1 1 1 10 1 1 1 1 0 
0 0 1 1 1 1 1 1 0 0 
0 0 0 1 5 1 1 0 0 0
0 0 0 0 1 1 0 0 0 0

