5
6
6 1 1 1 0 
1 1 1 1 1
0 1 7 1 0
0 1 1 1 0
0 1 1 1 0
0 1 5 1 0

