8
7
1 7 1 1 12 1 6 1
1 1 1 1 1 1 8 1
1 1 1 7 12 1 1 1
1 1 1 1 0 1 1 1
1 1 1 0 1 1 1 1
1 1 1 0 1 1 1 1
1 5 0 0 0 1 1 1


