10
11
0 0 0 0 0 0 0 6 1 0 
0 0 0 0 0 0 0 1 1 0 
0 0 0 0 0 0 0 1 1 0 
0 0 0 0 0 0 1 9 1 0 	
0 0 0 0 0 0 12 1 12 0 
0 0 0 0 0 0 1 1 0 0 
0 0 0 0 1 1 1 1 0 0 
0 0 0 0 1 1 1 1 0 0 
1 1 1 12 1 1 1 1 1 1 
1 1 1 1 1 1 1 1 9 1 
1 5 1 12 1 1 1 1 1 1 
