20
10
0 0 0 0 0 0 0 0 0 0 0 0 0 0 0 0 0 0 1 6
0 0 0 0 0 0 0 0 0 0 0 0 0 0 0 0 0 1 1 1
0 0 0 0 0 0 0 0 0 0 0 0 0 0 0 0 1 1 1 0
0 0 0 0 0 0 0 0 0 0 0 0 0 0 0 0 1 1 0 0
0 0 0 0 0 0 0 0 1 1 1 1 1 1 1 1 1 7 0 0
0 0 0 0 0 0 0 0 1 1 1 9 1 1 1 1 1 1 0 0
0 0 0 0 0 1 1 1 1 1 1 1 1 1 0 0 0 0 0 0
0 0 0 0 0 1 1 1 1 1 1 1 9 1 0 0 0 0 0 0
5 1 1 1 1 1 8 0 1 1 1 1 1 1 0 0 0 0 0 0
1 1 1 1 1 1 8 0 0 0 0 0 0 0 0 0 0 0 0 0

