10
11
6 1 1 1 1 0 0 0 0 0
0 0 0 1 1 0 0 0 0 0
0 0 0 7 1 10 0 0 0 0
0 0 0 0 1 1 0 0 0 0
0 0 0 0 1 7 0 0 0 0
0 0 0 0 1 1 0 0 0 0
7 1 1 1 1 1 1 1 1 1
1 1 2 2 2 1 10 1 1 1
1 1 2 1 1 1 1 1 1 1
1 1 2 7 1 1 1 1 1 1
5 1 2 1 1 1 11 1 1 1
