10
11
0 0 0 0 0 0 0 5 1 0 
0 0 0 0 0 0 0 1 1 0 
0 0 0 0 0 0 0 1 7 0 
0 0 0 0 0 0 1 1 1 0 	
0 0 0 0 0 0 1 1 1 0 
0 0 0 0 0 0 1 1 0 0 
0 0 0 0 1 1 1 7 0 0 
0 0 0 0 7 1 1 1 0 0 
1 1 1 1 1 1 1 1 1 1 
1 1 1 1 11 1 1 11 1 1 
1 6 1 1 1 1 1 1 1 1 
