10
11
6 1 1 1 1 0 0 0 0 0
0 0 0 1 1 0 0 0 0 0
0 0 0 1 1 9 0 0 0 0
0 0 0 0 1 1 0 0 0 0
0 0 0 0 1 1 0 0 0 0
0 0 0 0 1 1 0 0 0 0
9 1 1 1 1 1 1 1 1 1
1 1 1 1 1 11 9 1 1 1
1 1 11 1 1 1 1 1 1 1
1 5 1 1 1 1 1 1 1 1
1 1 1 1 1 1 9 1 1 1
