10
8
1 6 1 1 1 1 1 1 1 1 
1 1 1 1 2 1 1 1 1 1
1 1 10 1 2 1 11 1 1 1
1 1 1 1 2 1 1 1 1 1
1 1 1 1 1 1 1 1 1 1
0 0 0 8 1 1 8 0 0 0
0 0 0 1 1 1 1 0 0 0
0 0 0 1 1 5 1 0 0 0
