8
7
1 4 1 1 1 1 6 1
1 1 1 1 2 1 1 1
1 1 1 1 4 1 1 1
1 1 1 1 0 1 1 1
1 1 1 0 1 1 1 1
1 1 1 0 1 1 1 1
1 5 2 2 2 1 1 1

8
8
1 4 1 1 1 1 6 1
1 1 1 1 2 1 1 1
1 1 1 1 4 1 1 1
1 1 1 1 1 1 1 1
1 1 1 1 0 1 1 1
1 1 1 0 1 1 1 1
1 1 1 0 1 1 1 1
1 5 2 2 2 1 1 1


