7
12
0 1 1 1 1 6 0 
1 1 1 1 1 1 1
1 1 1 1 1 1 1
1 7 1 1 1 1 1
1 1 1 1 1 1 1
1 1 1 1 1 1 1
1 1 1 1 1 1 1
1 1 1 1 1 1 1
1 1 1 1 1 1 1
1 1 2 2 2 1 1
1 1 1 1 1 1 1
1 1 1 5 1 1 1